engourdi | presque sans sensation, un peu paralysé | numb
creux | vide à l’intérieur ; profond | hollow
déployer | ouvrir complètement | to unfold
fauteuil | siège confortable avec accoudoirs | armchair
promettre | dire qu’on fera quelque chose | to promise
se plaindre | dire qu’on souffre ou qu’on n’est pas content | to complain
aiguë | très forte, vive (douleur, voix) | sharp, acute
péritonite | maladie grave du ventre | peritonitis
arpenter | marcher de long en large | to pace
mordre | serrer avec les dents | to bite
ongles | parties dures au bout des doigts | fingernails
feutré | doux, étouffé (son, lumière) | muffled, soft
jaune | couleur | yellow
odieux | très désagréable, méchant | hateful
profiter | tirer avantage | to take advantage
courant | qui se passe maintenant ; habituel | current
doux | pas violent ; agréable | gentle, soft
balbutier | parler difficilement | to stammer
souffle | air qui sort de la bouche | breath
sein | poitrine (souvent féminin) | breast
cils | petits poils des yeux | eyelashes
amener | conduire quelqu’un quelque part | to bring
tracasser | inquiéter, déranger | to worry
enfantin | comme un enfant | childish
chuchoter | parler très doucement | to whisper
amasser | rassembler en grande quantité | to pile up
avare | qui ne veut pas donner | stingy
guetter | attendre en observant | to watch for
trahir | montrer un secret ou un sentiment | to betray
frémir | trembler légèrement | to shiver
trou | ouverture | hole
sieste | petit sommeil après le repas | nap
replier | plier de nouveau | to fold back
endosser | mettre un vêtement ; accepter un rôle | to take on
longueur | mesure du long | length
grognon | de mauvaise humeur | grumpy
hargneux | agressif, méchant | snarling
soulagé | libéré d’un poids | relieved
génuflexion | action de plier le genou | genuflection
tant | autant ; très | so much
s'efforcer | essayer très fort | to strive
moitié | une part sur deux | half
signe | geste ou marque | sign
effrayé | qui a peur | frightened
aumônier | prêtre attaché à un groupe | chaplain
pataud | maladroit | clumsy
saccadé | pas régulier, par à-coups | jerky
évoluer | changer progressivement | to evolve
poussiéreux | plein de poussière | dusty
baies | fruits ou ouvertures (fenêtres) | berries / bays
estivants | personnes en vacances d’été | summer visitors
califourchon | assis à cheval sur quelque chose | astride
armateur | propriétaire de bateaux | shipowner
lotissement | quartier de maisons | housing development
immaculée | très blanche, pure | spotless
solennités | cérémonies importantes | solemn ceremonies
