arpenter | marcher de long en large | to pace
feutré | doux, étouffé (son, lumière) | muffled
onctuosité | douceur exagérée | oiliness
déployer | ouvrir complètement | to unfold
demeurer | rester | to remain
insister | répéter, vouloir absolument | to insist
effleurer | toucher légèrement | to brush
percer | traverser ; comprendre | to pierce
retenue | contrôle de soi | restraint
guetter | attendre en observant | to watch for
tracasser | inquiéter | to bother
balbutiement | parole difficile | stammering
dérobée | cachée | hidden
fugace | très court | fleeting
lenteur | manque de rapidité | slowness
suspendu | arrêté momentanément | suspended
frisson | petit tremblement | shiver
détourner | changer de direction | to turn away
s'imposer | devenir évident | to impose itself
figer | rendre immobile | to freeze
révéler | montrer clairement | to reveal
oppressant | qui donne une gêne | oppressive
enveloppant | qui entoure | enveloping
pesant | lourd ; difficile | heavy
attentif | qui observe bien | attentive
contenir | retenir à l’intérieur | to contain
échapper | partir sans contrôle | to escape
s'installer | commencer à exister | to settle in
fixer | regarder longtemps | to stare
interrompre | arrêter quelqu’un | to interrupt
atténué | rendu moins fort | softened
confus | pas clair | confused
inerte | sans mouvement | motionless
trouble | pas clair | unclear
ressentir | sentir intérieurement | to feel
s'immiscer | entrer peu à peu | to creep in
relever | remarquer | to notice
fasciné | très attiré | fascinated
muet | sans parole | mute
